	timestamp	user_edits	anonymous_edits	group-bot_edits	name-bot_edits	all-editor-types_edits	user_editors
0	2001-01	0	0	0	0	0	0
1	2001-02	0	0	0	0	0	0
2	2001-03	0	0	0	0	0	0
3	2001-04	0	0	0	0	0	0
4	2001-05	0	0	0	0	0	0
5	2001-06	0	0	0	0	0	0
6	2001-07	0	0	0	0	0	0
7	2001-08	0	0	0	0	0	0
8	2001-09	0	0	0	0	0	0
9	2001-10	0	0	0	0	0	0
10	2001-11	0	0	0	0	0	0
11	2001-12	0	0	0	0	0	0
12	2002-01	0	0	0	0	0	0
13	2002-02	1	4	0	0	5	1
14	2002-03	8	3	0	0	11	1
15	2002-04	1	1	0	0	2	1
16	2002-05	57	21	0	0	78	3
17	2002-06	3	1	0	0	4	1
18	2002-07	2	1	0	0	3	1
19	2002-08	150	10	0	0	160	2
20	2002-09	228	17	0	0	245	4
21	2002-10	387	404	0	0	791	12
22	2002-11	263	58	0	0	321	7
23	2002-12	798	234	0	0	1032	10
24	2003-01	1147	207	0	0	1354	17
25	2003-02	4303	830	0	0	5133	13
26	2003-03	1981	1277	0	0	3258	15
27	2003-04	2018	338	0	0	2356	14
28	2003-05	3450	512	0	0	3962	22
29	2003-06	4623	402	0	0	5025	26
30	2003-07	3085	427	0	0	3512	19
31	2003-08	4113	460	0	0	4573	32
32	2003-09	3745	1126	0	0	4871	37
33	2003-10	3042	836	13	0	3891	33
34	2003-11	3810	925	833	0	5568	39
35	2003-12	4900	769	1846	0	7515	45
36	2004-01	3835	953	156	5	4949	42
37	2004-02	5622	1333	3551	4	10510	69
38	2004-03	6419	1404	1141	3	8967	103
39	2004-04	5280	1300	178	24	6782	101
40	2004-05	4346	1081	55	12	5494	78
41	2004-06	3746	2081	44	362	6233	85
42	2004-07	7373	903	839	12	9127	92
43	2004-08	10438	1346	61	14	11859	96
44	2004-09	6517	1175	2888	6	10586	100
45	2004-10	5190	1251	18	27	6486	117
46	2004-11	7147	1652	16	22	8837	137
47	2004-12	5566	1596	72	111	7345	133
48	2005-01	6334	1623	4973	321	13251	130
49	2005-02	4887	1364	5	2	6258	127
50	2005-03	5381	1600	3	7	6991	133
51	2005-04	10413	2594	951	2	13960	219
52	2005-05	19991	3006	160	9	23166	222
53	2005-06	13857	3094	131	97	17179	257
54	2005-07	15840	2813	1019	1653	21325	224
55	2005-08	20087	3299	4787	2757	30930	224
56	2005-09	8800	2927	7808	1551	21086	217
57	2005-10	12126	3240	309	4273	19948	228
58	2005-11	12508	3340	2828	2462	21138	231
59	2005-12	16252	4161	1241	3845	25499	270
60	2006-01	20787	6108	198	3865	30958	382
61	2006-02	16128	4273	490	3609	24500	346
62	2006-03	19222	5232	1455	7164	33073	398
63	2006-04	20395	5249	648	5823	32115	404
64	2006-05	15524	5214	3875	7249	31862	464
65	2006-06	19710	5956	7140	6599	39405	506
66	2006-07	22012	3946	1251	10364	37573	489
67	2006-08	20272	4737	1941	11290	38240	516
68	2006-09	20551	6296	1018	11424	39289	541
69	2006-10	19983	8066	5766	13229	47044	612
70	2006-11	16620	8418	267	15148	40453	641
71	2006-12	15603	8103	6719	12133	42558	691
72	2007-01	19909	8327	1455	19325	49016	880
73	2007-02	23783	5544	2856	11857	44040	1005
74	2007-03	25534	6879	349	20297	53059	1114
75	2007-04	25246	6535	280	14934	46995	984
76	2007-05	30412	6635	1821	16044	54912	1123
77	2007-06	25552	6453	3755	10135	45895	979
78	2007-07	23018	4767	804	9808	38397	816
79	2007-08	19292	5205	451	13479	38427	851
80	2007-09	23170	6163	161	16000	45494	1067
81	2007-10	23502	6760	581	20617	51460	1058
82	2007-11	26329	6816	323	19160	52628	1045
83	2007-12	21509	6386	73	17528	45496	1071
84	2008-01	31609	7831	1150	14201	54791	1189
85	2008-02	25950	6385	5365	15082	52782	1138
86	2008-03	23472	6673	707	15699	46551	1146
87	2008-04	22600	6057	526	18108	47291	1087
88	2008-05	24488	6483	1404	23214	55589	1126
89	2008-06	24032	6084	4184	21949	56249	1117
90	2008-07	20385	5275	944	19357	45961	993
91	2008-08	22634	5388	3591	23318	54931	1018
92	2008-09	21048	5448	1945	16345	44786	1147
93	2008-10	22683	6295	8413	20231	57622	1200
94	2008-11	21556	5319	6284	18087	51246	1260
95	2008-12	22360	5183	17396	17423	62362	1230
96	2009-01	29119	6324	17132	19056	71631	1416
97	2009-02	23110	6420	13186	16676	59392	1254
98	2009-03	25765	7111	21716	18621	73213	1291
99	2009-04	19441	6409	11846	21509	59205	1238
100	2009-05	21253	6623	12329	22182	62387	1293
101	2009-06	19579	6906	12431	20275	59191	1207
102	2009-07	20812	4725	14439	22396	62372	1023
103	2009-08	19572	5311	15409	22812	63104	1216
104	2009-09	18985	6188	4183	20620	49976	1225
105	2009-10	22295	5562	1125	18994	47976	1357
106	2009-11	21156	4810	23361	18762	68089	1344
107	2009-12	19055	4833	3317	20451	47656	1228
108	2010-01	23259	7675	11392	21764	64090	1319
109	2010-02	21331	7780	3562	25601	58274	1203
110	2010-03	31188	8246	35802	23667	98903	1222
111	2010-04	32788	7793	7771	23844	72196	1172
112	2010-05	21926	8261	2135	22199	54521	1137
113	2010-06	20606	6988	6317	27387	61298	1035
114	2010-07	16860	5045	2470	19425	43800	928
115	2010-08	22618	6873	5629	24229	59349	1069
116	2010-09	21737	7035	5406	23691	57869	1068
117	2010-10	23014	6925	3748	19046	52733	1111
118	2010-11	22280	6576	4200	18781	51837	1101
119	2010-12	20580	5702	7317	19925	53524	1044
120	2011-01	25315	7622	7393	24488	64818	1323
121	2011-02	24929	6795	6437	18335	56496	1176
122	2011-03	24127	7709	4554	23501	59891	1203
123	2011-04	22314	6821	4843	20051	54029	1062
124	2011-05	23891	6728	4047	21285	55951	1173
125	2011-06	18415	6780	6042	22399	53636	1051
126	2011-07	22720	5382	12260	21770	62132	993
127	2011-08	18578	6089	13424	18785	56876	1075
128	2011-09	19565	5747	8184	18310	51806	1076
129	2011-10	22204	6011	10921	19594	58730	1057
130	2011-11	18283	5874	4739	17950	46846	988
131	2011-12	17403	5478	6821	20736	50438	997
132	2012-01	22811	6559	4820	19491	53681	1124
133	2012-02	17690	6127	5852	16086	45755	1090
134	2012-03	17792	5928	5646	16051	45417	1114
135	2012-04	18221	5623	5350	16462	45656	993
136	2012-05	19078	5727	9040	20417	54262	1076
137	2012-06	18955	5671	10515	19359	54500	1011
138	2012-07	16281	4896	11343	18798	51318	890
139	2012-08	18327	5680	9920	16747	50674	973
140	2012-09	15893	5726	9156	13008	43783	938
141	2012-10	16096	5646	62542	16182	100466	1049
142	2012-11	15690	5519	15010	14221	50440	976
143	2012-12	24251	6677	16319	16286	63533	1002
144	2013-01	24398	7712	12360	17534	62004	1217
145	2013-02	23720	6719	18993	15464	64896	962
146	2013-03	23029	6455	129524	3722	162730	1028
147	2013-04	18654	5622	16070	311	40657	930
148	2013-05	16341	6257	6521	154	29273	994
149	2013-06	16085	5869	3624	199	25777	908
150	2013-07	16051	4692	2082	159	22984	793
151	2013-08	16624	5530	1206	201	23561	883
152	2013-09	16160	5234	1213	4	22611	900
153	2013-10	23704	4859	1496	1	30060	965
154	2013-11	18904	5191	6827	28	30950	906
155	2013-12	17443	4988	8818	9	31258	935
156	2014-01	19888	5092	6645	56	31681	1003
157	2014-02	16279	4612	2127	79	23097	930
158	2014-03	14407	4970	3816	104	23297	924
159	2014-04	14255	4096	3925	82	22358	858
160	2014-05	17809	4092	33176	125	55202	888
161	2014-06	17022	4153	1339	85	22599	837
162	2014-07	19524	3088	9050	158	31820	803
163	2014-08	17319	3263	2485	107	23174	945
164	2014-09	13613	4053	30162	55	47883	948
165	2014-10	13319	4252	1610	61	19242	1005
166	2014-11	14192	4582	2690	101	21565	932
167	2014-12	15068	4307	7048	42	26465	937
168	2015-01	18687	4991	3590	36	27304	1036
169	2015-02	17346	3850	2824	85	24105	963
170	2015-03	21319	4511	10574	119	36523	1084
171	2015-04	16969	4560	5171	86	26786	858
172	2015-05	16895	5241	4306	142	26584	888
173	2015-06	14295	4255	13395	62	32007	852
174	2015-07	14968	3205	9793	123	28089	769
175	2015-08	16859	3874	11022	427	32182	817
176	2015-09	20917	4619	5591	120	31247	815
177	2015-10	16625	4852	3400	85	24962	869
178	2015-11	13848	5848	2364	42	22102	891
179	2015-12	12516	5316	5798	69	23699	869
180	2016-01	19769	5215	3037	167	28188	926
181	2016-02	15726	4053	632	174	20585	860
182	2016-03	18042	4395	3032	147	25616	803
183	2016-04	14375	4224	2374	97	21070	843
184	2016-05	16736	3962	24830	139	45667	841
185	2016-06	16153	4414	1099	200	21866	779
186	2016-07	15548	4026	6287	175	26036	706
187	2016-08	16590	4162	2694	155	23601	770
188	2016-09	14118	4515	761	123	19517	815
189	2016-10	13992	4659	1300	46	19997	837
190	2016-11	20066	5672	6218	94	32050	918
191	2016-12	16483	4932	730	100	22245	867
192	2017-01	25596	5539	5821	364	37320	977
193	2017-02	19861	4701	2681	582	27825	926
194	2017-03	24902	5063	6351	1839	38155	901
195	2017-04	21495	4451	20268	472	46686	806
196	2017-05	15774	3980	2794	126	22674	843
197	2017-06	17228	3887	11148	84	32347	787
198	2017-07	18471	3044	14895	130	36540	734
199	2017-08	17321	4159	2092	166	23738	832
200	2017-09	13251	4401	2629	66	20347	823
201	2017-10	16436	4334	1223	40	22033	852
202	2017-11	14196	5143	690	67	20096	895
203	2017-12	14091	3808	1412	75	19386	779
204	2018-01	15056	5900	1441	74	22471	1002
205	2018-02	17093	4175	4502	121	25891	853
206	2018-03	22708	4236	4237	126	31307	890
207	2018-04	17447	3928	9841	14	31230	892
208	2018-05	16939	4404	7155	25	28523	888
209	2018-06	13760	3798	1058	7	18623	791
210	2018-07	15816	2859	3491	4	22170	760
211	2018-08	17362	4169	7015	3	28549	866
212	2018-09	13337	4554	1481	15	19387	850
213	2018-10	18148	4566	1621	6	24341	872
214	2018-11	15095	4571	2035	7	21708	869
215	2018-12	13192	4085	950	14	18241	828
216	2019-01	15058	4536	1194	4	20792	894
217	2019-02	14725	4107	1504	7	20343	888
218	2019-03	18373	4421	8724	83	31601	1040
219	2019-04	14180	3724	4374	134	22412	824
220	2019-05	14703	4808	8315	19	27845	861
221	2019-06	13821	4218	2307	45	20391	799
222	2019-07	15661	4015	1419	74	21169	737
223	2019-08	15667	4352	865	27	20911	857
224	2019-09	16400	4223	2411	29	23063	812
225	2019-10	18017	4474	1286	19	23796	784
226	2019-11	14367	4685	9215	4	28271	780
227	2019-12	15632	4616	13678	29	33955	817
228	2020-01	18391	4715	4724	109	27939	875
229	2020-02	18630	3981	2933	52	25596	856
230	2020-03	17870	3800	10831	34	32535	836
231	2020-04	16135	4619	2668	95	23517	831
232	2020-05	13540	4889	3870	27	22326	842
233	2020-06	13346	4005	1246	34	18631	770
234	2020-07	12320	3971	1368	36	17695	696
235	2020-08	15216	3862	2959	21	22058	769
236	2020-09	12451	4168	723	24	17366	774
237	2020-10	14375	5209	7444	63	27091	779
238	2020-11	12867	4108	789	60	17824	758
239	2020-12	13724	4744	1624	2	20094	750
240	2021-01	16975	6225	21178	101	44479	927
241	2021-02	12478	4876	1935	1	19290	814
242	2021-03	14673	5738	3821	13	24245	975
243	2021-04	13053	4604	27957	5	45619	842
244	2021-05	12357	5926	2867	27	21177	814
245	2021-06	9743	4399	2327	1	16470	675
246	2021-07	10606	3413	2276	8	16303	647
247	2021-08	14712	4352	1984	2	21050	756
248	2021-09	13379	3529	2742	2	19652	690
249	2021-10	13745	3052	1071	29	17897	742
250	2021-11	13094	4366	2741	52	20253	706
251	2021-12	14451	5365	28362	20	48198	788
252	2022-01	13800	3752	42384	39	59975	828
253	2022-02	11605	3579	15405	52	30641	737
254	2022-03	12922	2865	6856	32	22675	727
255	2022-04	15331	3671	9091	26	28119	698
256	2022-05	20461	4246	7100	35	31842	712
257	2022-06	13958	2981	1872	35	18846	713
258	2022-07	13790	3994	3755	17	21556	641
259	2022-08	12016	3074	1709	9	16808	739
260	2022-09	14603	3443	1516	56	19618	716
261	2022-10	18792	3431	5347	4	27574	697
262	2022-11	16236	3361	27373	16	46986	691
263	2022-12	13210	2754	2269	74	18307	629
