	timestamp	user_edits	anonymous_edits	group-bot_edits	name-bot_edits	all-editor-types_edits	user_editors
0	2001-01	0	0	0	0	0	0
1	2001-02	0	0	0	0	0	0
2	2001-03	0	0	0	0	0	0
3	2001-04	0	0	0	0	0	0
4	2001-05	0	0	0	0	0	0
5	2001-06	0	0	0	0	0	0
6	2001-07	0	0	0	0	0	0
7	2001-08	0	0	0	0	0	0
8	2001-09	0	0	0	0	0	0
9	2001-10	0	0	0	0	0	0
10	2001-11	0	0	0	0	0	0
11	2001-12	0	0	0	0	0	0
12	2002-01	1	0	0	0	1	1
13	2002-02	0	0	0	0	0	0
14	2002-03	0	0	0	0	0	0
15	2002-04	0	0	0	0	0	0
16	2002-05	0	0	0	0	0	0
17	2002-06	0	0	0	0	0	0
18	2002-07	5	5	0	0	10	3
19	2002-08	3	2	0	0	5	2
20	2002-09	0	0	0	0	0	0
21	2002-10	0	0	0	0	0	0
22	2002-11	0	0	0	0	0	0
23	2002-12	0	3	0	0	3	0
24	2003-01	0	20	0	0	20	0
25	2003-02	1	3	0	0	4	1
26	2003-03	0	0	0	0	0	0
27	2003-04	6	3	0	0	9	2
28	2003-05	4	1	0	0	5	3
29	2003-06	1	6	0	0	7	1
30	2003-07	0	0	0	0	0	0
31	2003-08	6	0	0	0	6	4
32	2003-09	8	8	0	0	16	5
33	2003-10	9	1	0	0	10	7
34	2003-11	4	6	0	0	10	4
35	2003-12	12	14	0	1	27	7
36	2004-01	8	11	0	2	21	6
37	2004-02	12	1	0	0	13	6
38	2004-03	65	4	0	7	76	15
39	2004-04	39	8	0	2	49	14
40	2004-05	28	2	0	5	35	11
41	2004-06	50	14	0	3	67	24
42	2004-07	28	15	0	2	45	18
43	2004-08	37	15	0	7	59	18
44	2004-09	27	9	0	1	37	14
45	2004-10	23	11	0	0	34	13
46	2004-11	31	10	0	3	44	14
47	2004-12	24	5	0	4	33	12
48	2005-01	30	19	0	2	51	19
49	2005-02	21	11	0	3	35	16
50	2005-03	26	7	0	1	34	16
51	2005-04	32	24	0	7	63	15
52	2005-05	22	13	0	2	37	19
53	2005-06	20	13	0	6	39	13
54	2005-07	35	31	0	3	69	25
55	2005-08	50	21	0	20	91	20
56	2005-09	72	4	0	12	88	25
57	2005-10	60	22	0	12	94	27
58	2005-11	39	25	0	11	75	22
59	2005-12	38	35	0	8	81	19
60	2006-01	47	20	0	9	76	18
61	2006-02	51	22	0	4	77	26
62	2006-03	50	24	0	6	80	30
63	2006-04	31	20	0	2	53	21
64	2006-05	44	30	0	3	77	25
65	2006-06	64	30	0	18	112	29
66	2006-07	47	24	0	12	83	32
67	2006-08	43	38	0	6	87	36
68	2006-09	75	51	0	3	129	43
69	2006-10	37	35	0	6	78	26
70	2006-11	228	92	0	11	331	34
71	2006-12	68	31	0	29	128	37
72	2007-01	83	53	0	36	172	27
73	2007-02	73	38	0	9	120	25
74	2007-03	114	34	0	14	162	45
75	2007-04	52	36	0	14	102	30
76	2007-05	194	49	0	20	263	53
77	2007-06	75	52	0	12	139	46
78	2007-07	101	100	0	18	219	43
79	2007-08	71	48	0	5	124	27
80	2007-09	146	44	0	15	205	34
81	2007-10	63	40	0	23	126	30
82	2007-11	36	22	0	17	75	22
83	2007-12	41	12	0	8	61	21
84	2008-01	30	35	0	20	85	20
85	2008-02	120	29	0	3	152	17
86	2008-03	32	27	0	0	59	19
87	2008-04	43	52	0	12	107	24
88	2008-05	38	34	0	29	101	21
89	2008-06	22	53	0	13	88	10
90	2008-07	27	40	0	1	68	21
91	2008-08	35	304	1	12	352	18
92	2008-09	41	70	0	37	148	10
93	2008-10	35	79	0	25	139	18
94	2008-11	42	30	0	22	94	15
95	2008-12	33	73	0	25	131	14
96	2009-01	29	65	0	19	113	18
97	2009-02	34	55	0	51	140	20
98	2009-03	16	24	0	20	60	13
99	2009-04	25	38	0	19	82	14
100	2009-05	29	26	0	12	67	8
101	2009-06	17	29	0	7	53	13
102	2009-07	42	53	0	22	117	18
103	2009-08	78	56	0	8	142	20
104	2009-09	246	27	0	7	280	26
105	2009-10	161	64	0	10	235	25
106	2009-11	632	41	0	16	689	15
107	2009-12	317	79	0	25	421	17
108	2010-01	210	97	0	57	364	26
109	2010-02	196	45	0	24	265	25
110	2010-03	192	61	0	21	274	20
111	2010-04	749	103	0	25	877	16
112	2010-05	1001	45	0	13	1059	18
113	2010-06	1067	41	0	11	1119	21
114	2010-07	540	54	0	29	623	26
115	2010-08	1806	136	0	848	2790	53
116	2010-09	1356	120	0	495	1971	37
117	2010-10	482	83	0	631	1196	29
118	2010-11	635	60	0	709	1404	23
119	2010-12	1144	24	0	758	1926	21
120	2011-01	662	50	0	735	1447	28
121	2011-02	293	32	0	494	819	23
122	2011-03	113	41	0	833	987	24
123	2011-04	140	44	0	652	836	26
124	2011-05	231	40	0	730	1001	29
125	2011-06	689	60	0	759	1508	23
126	2011-07	530	48	0	647	1225	17
127	2011-08	1227	26	0	620	1873	23
128	2011-09	1970	63	0	685	2718	33
129	2011-10	800	39	0	811	1650	24
130	2011-11	532	38	0	883	1453	23
131	2011-12	395	114	0	783	1292	23
132	2012-01	418	44	0	777	1239	33
133	2012-02	465	50	0	869	1384	30
134	2012-03	298	42	0	889	1229	23
135	2012-04	507	22	0	812	1341	19
136	2012-05	1119	57	0	1200	2376	25
137	2012-06	802	25	0	1145	1972	26
138	2012-07	782	33	0	1059	1874	23
139	2012-08	289	39	0	1003	1331	24
140	2012-09	708	23	0	907	1638	9
141	2012-10	223	37	0	935	1195	24
142	2012-11	924	35	0	1031	1990	34
143	2012-12	1160	25	0	2085	3270	28
144	2013-01	136	48	0	1286	1470	24
145	2013-02	391	50	0	1423	1864	26
146	2013-03	1593	66	0	3790	5449	17
147	2013-04	491	46	0	143	680	21
148	2013-05	174	68	0	26	268	25
149	2013-06	472	43	0	65	580	28
150	2013-07	1054	19	0	18	1091	16
151	2013-08	448	10	0	16	474	10
152	2013-09	239	10	0	5	254	13
153	2013-10	132	4	0	0	136	17
154	2013-11	134	8	0	5	147	8
155	2013-12	104	8	0	0	112	15
156	2014-01	262	11	0	0	273	8
157	2014-02	110	10	0	6	126	10
158	2014-03	64	8	0	0	72	10
159	2014-04	169	8	0	0	177	14
160	2014-05	67	5	0	0	72	9
161	2014-06	33	3	0	0	36	11
162	2014-07	144	12	0	3	159	9
163	2014-08	120	9	0	0	129	11
164	2014-09	47	7	0	0	54	5
165	2014-10	71	3	0	0	74	15
166	2014-11	84	4	0	5	93	7
167	2014-12	56	1	0	0	57	8
168	2015-01	98	4	0	22	124	10
169	2015-02	387	11	0	18	416	9
170	2015-03	1028	7	0	725	1760	8
171	2015-04	337	9	0	2	348	7
172	2015-05	799	16	0	10	825	14
173	2015-06	869	19	0	6	894	10
174	2015-07	830	10	0	9	849	16
175	2015-08	263	15	0	25	303	9
176	2015-09	596	9	0	6	611	7
177	2015-10	294	5	0	3	302	7
178	2015-11	417	8	0	5	430	20
179	2015-12	185	10	0	2	197	14
180	2016-01	148	21	0	1	170	4
181	2016-02	372	3	0	2	377	10
182	2016-03	22	3	0	3	28	8
183	2016-04	20	6	0	1	27	10
184	2016-05	46	2	0	3	51	5
185	2016-06	42	2	0	0	44	8
186	2016-07	318	3	0	5	326	10
187	2016-08	575	1	0	3	579	15
188	2016-09	149	2	0	0	151	12
189	2016-10	1293	11	0	0	1304	7
190	2016-11	993	2	0	6	1001	6
191	2016-12	441	7	0	0	448	11
192	2017-01	339	6	0	79	424	14
193	2017-02	491	12	0	3	506	10
194	2017-03	2484	5	0	4	2493	6
195	2017-04	304	7	0	0	311	14
196	2017-05	724	1	0	3	728	13
197	2017-06	1243	3	45	8	1299	11
198	2017-07	656	2	50	12	720	14
199	2017-08	624	1	22	10	657	8
200	2017-09	2573	1	177	5	2756	10
201	2017-10	2707	9	0	5	2721	12
202	2017-11	1810	3	13	2	1828	4
203	2017-12	1568	1	0	17	1586	7
204	2018-01	1148	2	5	5	1160	11
205	2018-02	908	1	0	6	915	10
206	2018-03	321	4	0	4	329	10
207	2018-04	117	7	0	0	124	12
208	2018-05	653	6	0	2	661	7
209	2018-06	375	2	0	0	377	5
210	2018-07	1760	1	41	6	1808	14
211	2018-08	3023	17	0	10	3050	16
212	2018-09	1641	12	22	64	1739	10
213	2018-10	1204	5	0	32	1241	11
214	2018-11	1346	0	208	30	1584	10
215	2018-12	2092	1	0	10	2103	11
216	2019-01	957	0	0	6	963	13
217	2019-02	1228	0	32	13	1273	10
218	2019-03	567	0	0	6	573	17
219	2019-04	340	2	0	1	343	13
220	2019-05	416	3	0	5	424	10
221	2019-06	1194	9	0	0	1203	11
222	2019-07	1028	0	0	9	1037	12
223	2019-08	252	5	0	1	258	6
224	2019-09	1549	0	0	0	1549	11
225	2019-10	1037	114	0	1	1152	12
226	2019-11	1401	5	0	6	1412	11
227	2019-12	2157	5	55	32	2249	16
228	2020-01	1534	5	357	6	1902	13
229	2020-02	1188	2	0	3	1193	10
230	2020-03	1725	7	0	5	1737	10
231	2020-04	2005	26	0	7	2038	13
232	2020-05	970	23	0	3	996	10
233	2020-06	1038	20	0	5	1063	18
234	2020-07	822	3	0	0	825	14
235	2020-08	941	4	64	13	1022	14
236	2020-09	1274	12	0	29	1315	15
237	2020-10	648	3	0	4	655	20
238	2020-11	2072	4	50	7	2133	10
239	2020-12	2509	1	0	54	2564	10
240	2021-01	1387	3	26	5	1421	11
241	2021-02	1387	5	22	23	1437	8
242	2021-03	719	4	0	4	727	9
243	2021-04	1008	2	0	12	1022	18
244	2021-05	2434	1	0	76	2511	15
245	2021-06	1904	5	0	8	1917	12
246	2021-07	1903	3	0	2	1908	20
247	2021-08	1016	6	0	29	1051	17
248	2021-09	1139	4	0	4	1147	12
249	2021-10	2678	22	0	30	2730	15
250	2021-11	598	3	0	4	605	20
251	2021-12	1394	5	0	27	1426	19
252	2022-01	2168	1	0	18	2187	21
253	2022-02	2507	27	0	23	2557	21
254	2022-03	2148	4	0	14	2166	18
255	2022-04	1552	2	0	22	1576	14
256	2022-05	679	5	0	18	702	11
257	2022-06	733	49	0	5	787	12
258	2022-07	1112	5	107	16	1240	10
259	2022-08	721	2	0	2	725	18
260	2022-09	1442	2	0	615	2059	21
261	2022-10	1017	17	58	849	1941	21
262	2022-11	78	7	0	468	553	11
263	2022-12	1090	15	0	487	1592	16
